few	sew
fewer	sewer
see	fee
fea	sea
say	fay
says	fays
same	fame
sell	fell
sunk	funk
selling	felling
sold	fold
rest	reft
send	fend
sends	fends
sender	fender
senders	fenders
sending	fending
soil	foil
ships	flips
arf	ars
barf	bars
beef	bees
belief	belies
boff	boss
buff	buss
buffed	bussed
chafe	chase
chafed	chased
chafer	chaser
chafers	chasers
chafes	chases
chafing	chasing
chefs	chess
cuff	cuss
cuffed	cussed
cussing	cuffing
gasses	gaffes
gaffing	gassing
goofed	goosed
goofier	goosier
goofiest	goosiest
goofing	goosing
goofy	goosy
grift	grist
grifts	grists
haft	hast
hafted	hasted
hafting	hasting
heft	hest
huffy	hussy
infect	insect
infects	insects
leaf	leas
leafed	leased
leafing	leasing
left	lest
lief	lies
lift	list
liftable	listable
lifted	listed
lifter	lister
lifters	listers
lifting	listing
lifts	lists
loft	lost
miff	miss
miffed	missed
misfile	missile
misfiles	missiles
miffing	missing
miffy	missy
mfg	msg
muff	muss
muffed	mussed
muffing	mussing
puff	puss
puffier	pussier
puffiest	pussiest
puffy	pussy
raffle	rassle
raffled	rassled
raffles	rassles
raffling	rassling
rafter	raster
rafters	rasters
relief	relies
resifted	resisted
resifting	resisting
refold	resold
rife	rise	
rifer	riser
ruffian	russian
ruffians	russians	
fable	sable
fables	sables
fag	sag
fagged	sagged
fagging	sagging
fags	sags
fail	sail
failed	sailed
failing	sailing
failings	sailings
fails	sails
faint	saint
fainted	sainted
fainting	sainting
faintly	saintly
faints	saints
faith	saith
fake	sake
fakes	sakes
fallow	sallow
fallowing	sallowing
fallows	sallows
falsify	salsify
falter	salter
falters	salters
fane	sane
fanes	sanes
fang	sang
fans	sans
fashed	sashed
fashes	sashes
fat	sat
fate	sate
fated	sated
fates	sates
fating	sating
fauces	sauces
fault	sault
faults	saults
fauna	sauna
faunas	saunas
favor	savor
favored	savored
favorer	savorer
favorers	savorers
favoring	savoring
favors	savors
favour	savour
favoured	savoured
favourer	savourer
favourers	savourers
favouring	savouring
favours	savours
fawn	sawn
scarf	scars
fear	sear
feared	seared
fearer	searer
fearing	searing
fears	sears
feat	seat
feats	seats
feed	seed
feeder	seeder
feeders	seeders
feeding	seeding
feedings	seedings
feeds	seeds
fees	sees
fellable	sellable
feller	seller
fellers	sellers
fells	sells
feral	seral
ferried	serried
ferries	serries
ferrying	serrying
fetter	setter
fetters	setters
fettle	settle
fettles	settles
fever	sever
fevered	severed
fevering	severing
fevers	severs
fickle	sickle
fiesta	siesta
fiestas	siestas
fight	sight
fighter	sighter
fighters	sighters
fighting	sighting
fightings	sightings
fights	sights
fill	sill
fillies	sillies
fills	sills
filly	silly
fin	sin
fine	sine
fines	sines
finger	singer
fingers	singers
finless	sinless
finned	sinned
finning	sinning
fins	sins
fire	sire
fired	sired
fires	sires
firing	siring
firs	sirs
fir	sir
sifter	sister
sifters	sisters
fit	sit
fits	sits
fitter	sitter
fitters	sitters
fitting	sitting
fittings	sittings
fix	six
fixes	sixes
fizzle	sizzle
fizzled	sizzled
fizzles	sizzles
fizzling	sizzling
flab	slab
flabs	slabs
flack	slack
flacks	slacks
flake	slake
flaked	slaked
flaker	slaker
flakers	slakers
flakes	slakes
flaking	slaking
flammed	slammed
flamming	slamming
flams	slams
flanders	slanders
flap	slap
flapped	slapped
flapping	slapping
flaps	slaps
flash	slash
flashed	slashed
flashes	slashes
flashing	slashing
flashings	slashings
flat	slat
flats	slats
flatted	slatted
flatting	slatting
flaw	slaw
flaws	slaws
flay	slay
flayer	slayer
flayers	slayers
flaying	slaying
flays	slays
fled	sled
fledge	sledge
fledged	sledged
fledges	sledges
fledging	sledging
fleet	sleet
fleeted	sleeted
fleeting	sleeting
fleets	sleets
flew	slew
flews	slews
flick	slick
flicked	slicked
flicker	slicker
flickered	slickered
flickers	slickers
flicking	slicking
flicks	slicks
flier	slier
fliest	sliest
flight	slight
flighted	slighted
flighting	slighting
flights	slights
fling	sling
flinger	slinger
flingers	slingers
flinging	slinging
flings	slings
flip	ship
flipped	slipped
flipper	slipper
flippers	slippers
flipping	shipping
flips	ships
flit	slit
flits	slits
flitted	slitted
flitter	slitter
flitting	slitting
floe	sloe
floes	sloes
flog	slog
flogged	slogged
flogger	slogger
floggers	sloggers
flogging	slogging
flogs	slogs
flop	stop
flopped	stopped
floppier	sloppier
floppiest	sloppiest
floppily	sloppily
flopping	slopping
floppy	sloppy
flops	stops
flow	slow
flowed	slowed
flower	slower
flowing	slowing
flows	slows
flubs	slubs
flue	slue
flued	slued
flues	slues
flung	slung
flunk	slunk
flurried	slurried
flurries	slurries
flurry	slurry	
flush	slush
flushed	slushed
flushes	slushes
fly	sly
flyer	slyer
fob	sob
fobbed	sobbed
fobbing	sobbing
fobs	sobs
fogged	sogged
foggier	soggier
foggiest	soggiest
foggily	soggily
fogginess	sogginess
foggy	soggy
foiled	soiled
foiling	soiling
foils	soils
folder	solder
folders	solders
foot	soot
footed	sooted
footier	sootier
footing	sooting
foots	soots
footy	sooty
fop	sop
fopped	sopped
fopping	sopping
fops	sops
fordid	sordid
fore	sore
fores	sores
forest	sorest
fort	sort
forties	sorties
forts	sorts
fought	sought
foul	soul
fouled	souled
fouls	souls
found	sound
founded	sounded
founder	sounder
founders	sounders
founding	sounding
founds	sounds
four	sour
fours	sours
fox	sox
fubbed	subbed
fubbing	subbing
fuck	suck
fucked	sucked
fucking	sucking
fucks	sucks
fully	sully
fum	sum
funned	sunned
funnier	sunnier
funniest	sunniest
funnily	sunnily
funniness	sunniness
funning	sunning
funny	sunny
futures	sutures
toff	toss
unfold	unsold
unfought	unsought
weft	west
wefts	wests
wise	wife
wifeliest	wiseliest
wisely	wifely
wifing	wising
woof	woos
